+   +---+---+---+---+
|                   |
+   +---+---+---+   +
|   |               |
+   +   +---+---+---+
|   |   |           |
+   +---+   +---+---+
|           |       |
+   +---+---+---+   +
|                   |
+---+---+---+---+   +
